111111111111111111111
100000C00000111000001
10000E000001100001111
100000000C000000C0111
100000000C000000C0111
100000000C000000C0111
10000C00P000000000001
111111111111111111111