11111111111111111
10000C00000100001
100000D0000111101
10000000C000C0001
10000000C0E111101
10110000C00100011
10110000C00100001
10110000C00100001
10110000C00100001
10C1C00P0001C1CD1
11111111111111111
