111111111111111111111
100000C000000000E0001
1000000D0000000000001
100000000C00000DC0001
100000000C00000111101
100000000C000001C0001
1C000C00P000000111001
111111111111111111111