1111111111111111111111
100000C000001110000011
1C000E0000011000111111
1000C00000000000C01111
10000C00P0000000000001
1111111111111111111111