111111111111111
1DC000000000001
1C1C10000010101
10C01000001C1C1
101110D0D010101
100001101100001
10D0011E1100001
100001111100001
101100DCD001011
101110DCD011011
10C110DCD011011
1D0C100P001CCC1
111111111111111