111111111111
100000000011
1C000E111111
100000001111
1000000000P1
111111111111