111111111111111111
10000C000001000011
100000D00001111011
10000000C000C00011
10000C000001000011
100000D00001111011
10000000C000C00011
10000C000001000011
10000000C000C00011
10000000C0E1111011
10110000C001000011
10C1C00P0001C1C011
111111111111111111