11111111111111111111111111111111111111111111111111111111111111111111111111111111111111111111111111111111111111111111111
10000C00000100001111111111111111111111111111111111111111111111111111111111111111111111111111111111111111111111111111111
100000D0000111101111111111111111111111111111111111111111111111111111111111111111111111111111111111111111111111111111111
10000000C000C0001111111111111111111111111111111111111111111111111111111111111111111111111111111111111111111111111111111
10000C00000100001111111111111111111111111111111111111111111111111111111111111111111111111111111111111111111111111111111
100000D0000111101111111111111111111111111111111111111111111111111111111111111111111111111111111111111111111111111111111
10000000C000C0001111111111111111111111111111111111111111111111111111111111111111111111111111111111111111111111111111111
10000C00000100001111111111111111111111111111111111111111111111111111111111111111111111111111111111111111111111111111111
100000D0000111101111111111111111111111111111111111111111111111111111111111111111111111111111111111111111111111111111111
10000000C000C0001111111111111111111111111111111111111111111111111111111111111111111111111111111111111111111111111111111
10000C00000100001111111111111111111111111111111111111111111111111111111111111111111111111111111111111111111111111111111
100000D0000111101111111111111111111111111111111111111111111111111111111111111111111111111111111111111111111111111111111
10000000C000C0001111111111111111111111111111111111111111111111111111111111111111111111111111111111111111111111111111111
10000000C0E111101111111111111111111111111111111111111111111111111111111111111111111111111111111111111111111111111111111
10110000C00100001111111111111111111111111111111111111111111111111111111111111111111111111111111111111111111111111111111
10C1C00P0001C1C01111111111111111111111111111111111111111111111111111111111111111111111111111111111111111111111111111111
11111111111111111111111111111111111111111111111111111111111111111111111111111111111111111111111111111111111111111111111