11111111111111111
100000D0000111101
100000P0C00000001
10000000C0E111101
11111111111111111