111111111111111
101110D0D010101
100000000000001
10DP011E1100001
100001111100001
1011000CD001011
111111111111111