111111111111111
1100000000000E1
111110000001111
10D00C000000001
111111111111111