111111111111111
11000000E000001
111110000001111
10000C0000000P1
111111111111111