
111111111111111
1100000000000E1
111110000001111
1D000C0000000P1
111111111111111