111111111111111
11D0000000000E1
111110000001111
1P000C0000000P1
111111111111111