111111111111111
11D0000000000E1
111110000011111
1C1000C000000P1
111111111111111